xxxxxxxxxxxxxxxxxxxxxxxxxxxxxx
x                            x
x                            x
x                            x
x                            x
x                            x
x                            x
x                            x
x                            x
x             x              x
x       x    xxx    x        x
x      xx   xxxxx   xx       x
x     xxx  xxxxxxx  xxx      x
x    xxxx xxxxxxxxx xxxx     x
x           xEx              x
x           x x              x
x           x x              x
x           x x              x
x           x x              x
x       xxxx   xxxx          x
x        xxx   xxx           x
x         xx   xx            x
x          x   x             x
x                            x
x                            x
x                            x
x                            x
x                            x
x                            x
xxxxxxxxxxxxxxxxxxxxxxxxxxxxxx